__M__SSH__B___BM<M<M
T____SSS_MS_M_BMTT<<
___SSSSSSSSSBTTTBBBB
_M_SSM____SSMTTMMTBB
___SS_T_____BTTBTTT_
__>SS___V___STBB>T__
_M__S_____T_STHTTM__
_T_SS_T____MSTT____M
_>SSSM__SS__S_M_W___
M_S_SS_SSSSSS_____M_
__SS___SSSSSS_M___T_
_T_B___BM-M<S___M_T_
___SS_SSM<_<_M___SS_
_M__SSSSM_MTT__M_SHM
H___M__SSS_M--_SSSSS
